...P..P...O.
.O.T.......P
....P.......
U.....U...O.
...........H
..D.........
P...........
............
....TP.....T
..P....dT.P.
......U.....
.D........d.
